upci: bkcu * qgdu
srcr: 3
hbxd: cyyc - vugu
itga: hfqt + twlh
dkwp: nqoa - rzim
fkrn: ebwd * kzgt
oqbz: vaab + uedl
wcbb: njdv - xkyy
kbsc: viuq - yrez
wrpn: gpgb * dugr
cexg: zdoy - mloe
bwzn: fcpi * iwea
vndm: 2
oigl: gwwn * iosi
xggu: faen - mswk
doqu: humn + cyyc
ljbd: cyyc + vugu
uuyz: humn * xkyy
yrez: qduf * gdte
ypai: humn - nqoa
nfud: xkyy - qduf
nwsf: nqoa + vugu
vxzk: gwbq * pybi
oyab: qglm * zpll
fpvw: wrpn * mfwz
xork: qduf * rzim
nvgw: gdte * cyyc
rqtv: gfcr - nqoa
hfoj: rzim * xkyy
uqae: humn + qduf
cqco: nqoa - njdv
dvde: gdte * xkyy
ufqc: dvde + owbk
qbzq: gdte + rzim
aaec: ojub * chbi
mqym: nqoa * xkyy
yqao: humn * gdte
fztx: uucu * leiq
gdzl: humn - kshz
qquk: humn * gdte
vowb: vugu + xkyy
swjd: jbnv - bgdt
xbrw: nqoa - gdte
hlgs: bivc + qgwr
zkzr: zmzc + tqju
bkcu: humn + cyyc
kzgt: bjcc - nrco
gimi: gdte + nqoa
bivc: yhtg - ndpb
pfgk: duss - uuyz
leiq: rzoi - zkzr
tnzw: nqoa * vugu
czmo: oigl * muid
ejih: pfgk * oyab
rhlm: vugu - gdte
jaub: rzim * cyyc
coeo: qquk + fgmw
hanq: humn - srcr
bgdt: njdv + qduf
xcph: qqbd * qfaj
yazr: wxcw + zwrg
rzoi: scja * kmhi
yhtg: nvgw - zfgr
kvlu: skgb + qvsw
qrls: kcte * rrgn
eqgg: ljbd * mewc
pjtj: bwfs * khfd
llki: iwrt + tmbw
sdyd: gfcr * gdte
uucu: hdza - hxih
tzxe: ekms * oqbz
rbfu: eqgg * dkhj
kxun: upvj * wgrw
wxcw: gfcr * njdv
mfwz: qzql * iqlc
rcxu: 4
viuq: gfcr - njdv
lxds: humn + rcxu
bwfs: bxzy + hxxr
tidi: zals + pqcl
onjw: qduf + rzim
hmsd: humn - gfcr
gwwn: rzim + njdv
eemv: mqym - jbmv
kshz: 7
uedl: bujs + vxtu
stxx: tzxe + vlnx
vedt: nqoa * vugu
swgi: kbsc - clhq
qzql: dkad - bwzn
ezkc: njdv + cyyc
valk: yqao + erqb
nsis: qduf - njdv
bmrn: hidm - xbrw
jdcq: vowb - mnvp
gwbq: xgcm * wpfx
hmyp: jaub + nnib
byuu: jbwc + klya
ujgk: xkyy * gdte
zjzf: gdte - gfcr
dtns: vxzk * gdzl
pqcl: rzim * xkyy
nrco: iagz - tvlu
hyxt: njdv * gdte
muid: nsis * zfmt
humn: 1
rgyz: njdv - cyyc
iqlc: dzqr * hnnx
wiop: bjyg - sdyd
pwwo: xkyy + qduf
kxwj: cyyc + xkyy
hnnx: ixlc + klho
rvok: vugu * gdte
tmbw: pwwo - trwg
xgcm: cxrw * bwha
dugr: ejih + qrls
klho: znyy - vedt
bjyg: nqoa + gfcr
nqoa: 4
gmcy: cyyc + njdv
dtls: humn - zclk
hrni: nqoa - humn
clhq: uqae * fumw
twlh: gdte + qduf
gfcr: 8
hjkp: rzim - nqoa
qcfs: bbly + tbjz
jbso: vugu * xkyy
qbdf: rzim - gfcr
asvu: kgui + gsbd
mloe: qduf + xkyy
twud: humn + ftbj
cyyc: 5
hfqt: gfcr + njdv
ojub: oxna - tnzw
ebwd: ucze - fztx
ldhy: qbzq + vlfo
uylo: nqoa + qduf
dhou: wcbb + lpay
qzwi: xkyy - nqoa
zfmt: cyyc + qduf
ekms: abxj + valk
bjcc: kkww + aaec
cwof: cyyc + njdv
rzim: 9
erqb: njdv * xkyy
ftbj: 6
bujs: nqoa + gdte
pewf: humn * qduf
qgdu: nqoa + humn
owbk: gdte * rzim
alqw: czmo - swgi
iwea: gimi - cqco
tzfe: cyyc + njdv
gyyb: asvu * hmyp
bwha: humn + vndm
xfbs: njdv * cyyc
hzkb: vbdq + fjtm
nals: doqu * ezkc
dioa: qduf * xkyy
crwq: nqoa * rzim
jbwc: vugu * nqoa
xaiv: ypai * nuxx
wsdf: xfqv * uiwb
iwrt: jbso + nzri
gwny: skrl + epmc
jbnv: vugu * humn
faen: suyz - fkrn
trwg: rzim - gdte
ddni: humn + cyyc
vxtu: xkyy * humn
dkad: xcph * bmrn
vawl: rhlm * kxwj
nuxx: njdv + cyyc
kthg: kxun - stxx
wpfx: hanq * lxds
nnib: gdte * qduf
xkyy: 1
xfqv: cyyc * gdte
vxjr: njdv + vugu
kcte: qdie + pewf
zclk: 5
gdte: 5
ztgy: 1
rrgn: jpya - zjzf
iyuf: hrni * ujgk
vbdq: nqoa + cyyc
rqyh: humn + xkyy
wmoe: nals * wiop
zals: xkyy - qduf
njdv: 4
kkww: coeo * djvw
hwgn: humn - rzim
qduf: 7
gsbd: humn - vugu
fgmw: njdv + qduf
bbly: lhaa * ioae
jvxq: yazr * tsca
fjtm: xkyy * rzim
ixlc: qbdf + hfoj
vlnx: pjtj - mwlt
wgrw: pmrs + dbxc
ahnv: njdv + qduf
qdie: gfcr - gdte
cknd: nqoa * njdv
mpod: humn - vugu
tbjz: mphm * ldhy
dzqr: gwny - zvjt
otri: cyyc + rzim
uhjr: qcfs + kvlu
dbxc: tidi + swjd
skgb: dhou - xaiv
nvtm: xkyy * vugu
vaab: hjkp * tzfe
ndpb: ftti + cwof
tvlu: itga * jdcq
zvjt: qzwi * ahnv
moam: humn + vugu
uiwb: nqoa - njdv
chbi: cknd - dkwp
tqju: vugu * rzim
vlfo: gdte * gfcr
zwrg: vugu * gfcr
hxjn: nvtm + nwsf
jpya: xkyy * qduf
jwos: njdv * humn
zdoy: njdv * humn
duss: vugu - nqoa
qqbd: vugu - cyyc
ioae: xork * gmcy
root: dtns + xggu
khfd: rqtv + vvis
vugu: 8
lhaa: crwq - xfbs
kmhi: gdte * qduf
ucze: rbfu * wmoe
hidm: humn * nqoa
wggm: hwgn + moam
qglm: qduf * xkyy
abxj: rqyh + amhk
qfaj: njdv + rzim
fcpi: hyxt + hbxd
kgui: xkyy + njdv
mnvp: gfcr - humn
nzri: gfcr * humn
pmrs: vawl + eemv
qvsw: ufqc * upci
hxih: fueb + hmsd
djvw: vxjr - rvok
hdza: mpod + dioa
oxna: nqoa - xkyy
upvj: jvxq + chef
bxzy: gdte - humn
epmc: cyyc * gdte
suyz: uhjr * eovp
chef: quad * wggm
jbmv: njdv * vugu
iagz: wsdf * iyuf
rwnq: xkyy + humn
skrl: njdv * nqoa
quad: jwos - rwnq
zpll: xkyy - njdv
eovp: alqw * hlgs
fumw: humn - xkyy
iosi: vugu - humn
lpay: rzim - cyyc
fueb: qduf + gdte
pybi: dtls * twud
mwlt: byuu - cexg
zmzc: njdv * qduf
scja: humn + xkyy
hxxr: gdte + qduf
amhk: qduf * cyyc
qgwr: hzkb - hxjn
znyy: gdte * gfcr
ftti: xkyy + qduf
mphm: nfud - uylo
gpgb: llki - gyyb
cxrw: humn - ztgy
mswk: fpvw * kthg
mewc: vugu + xkyy
tsca: otri + rgyz
dkhj: ddni * onjw
klya: cyyc * gfcr
vvis: humn * gfcr
zfgr: nqoa - gdte